staart tail — queue — braid
ouders parents — mother — father
knoflook garlic — massor dahl — tarka dahl
mei May — may — month
zorg care — concern — worry
dinsdag Tuesday — day — tuesday
eergisteren day before yesterday — the day before yesterday — ereyesterday
negen nine — o'clock
pan pan — saucepan — pot
hoofd head — pate — leader
roos rose — dandruff — pink
verbeteren correct — improve — ameliorate
drank drink — beverage — liquor
rups caterpillar — larva — maggot
idee idea — thought — notion
meeuw gull — seagull — mew
taal language — tongue — speech
rust rest — peace — repose
kom bowl — basin — pelvis
april April — month
zitten sit — take a seat — sits
computer computer — terminal — interface
betalen pay — foot — shell out
oog eye — dot — hole
wind wind — fart — breeze
je you — thou — your
klok clock — bell — watch
geel yellow — canker — amber
vrijdag Friday — Sabbath — day
werken work — operate — works
arts doctor — physician — medic
blijven stay — remain — keep
naam name — reputation — appellation
goedkoop cheap — inexpensive — cheaply
november November — november
staan stand — clothe — be
tekenen draw — mark — sign
nacht night — at night — night-time
stuk piece — part — chunk
winter winter — wintertide — wintertime
rook smoke — fume — reek
bliksem lightning — thunderbolt — flash
melk milk — liquid bomb — yarrum
afstand distance — abandonment — range
Italiaans Italian — Italian language — italian
lood lead — lot — graphite
tijger tiger — tigress — leopard
regenboog rainbow
steen stone — rock — gem
zand sand — grit — gravel
wortel root — carrot — square root
eeuw century — centennial — age
informatie information — data — information source
gewoonte habit — custom — way
fluit flute — whistle — pipe
strand beach — shore — strand
baard beard — whiskers — bit
daar there — because — since
dochter daughter — girl — female offspring
werk work — labour — job
leeuw lion — Leo — lioness ж.
Azië Asia — barn swallow
voorbeeld example — instance — sample
hagedis lizard — push up — press up
geloven believe — think — opine
verliezen lose — loss — forfeit
lucht air — sky — atmosphere
neus nose — peak — point
vrucht fruit — result — fruition
Letland Latvia — Republic of Latvia — Low Saxon
Denemarken Denmark — Denemarken — Elsinore
deksel lid — cover — top
kip chicken — hen — kip
hamer hammer — cock — malleus
schaap sheep — lamb — mutton
brengen bring — wear — carry
hand hand — arm — handshake
vandaag today — to-day — day
leiden lead — guide — head
bereiken reach — achieve — attain
suiker sugar — pinch cake — crushed sugar
blad leaf — sheet — blade
keel throat — gullet — gules
lucifer match — matchstick — light
komen come — arrive — cum
minuut minute — minute of angle — arcminute
moeten must — need — ought
student student — scholar — pupil
beker mug — cup — beaker
vakantie vacation — holiday — holidays
groot big — large — tall
hij he — it — she
autobus bus — coach — autobus
Afghanistan Afghanistan — Afganistan — kaymak
zilver silver — argent — meergries
vrouw woman — wife — queen
hoe how — as — like
zwaar heavy — hard — arduous
laars boot — top boot — shoe
huwelijk marriage — matrimony — wedding